   ########
#### @ # .#
#    # # .#
#    $ # .#
#####$ # .#
 #  #  . .#
 #$ #  #  #
##  #$ ####
# $ $    #
#     #  #
##########
