######################
#                    #
#                . .@#
#                 .  #
#                . . #
#                    #
#                    #
#                    #
#                    #
#                    #
#   $ $              #
#    $               #
#   $ $              #
#                    #
#                    #
######################
